s 5 10 5
0000110000
0022332200
1133553311
0022332200
0000110000
---
0120120120
0340340340
0000000000
0120120120
0340340340
---
1111502222
1111502222
0000000000
3333054444
3333054444
---
1020304050
0504030201
1020304050
0504030201
1020304050
---
1234512345
5123451234
4512345123
3451234512
2345123451
---
